############################################################
############################################################
##                                                         P
##  # # # # # # # # # # # # # # # # # # # # # # # # # # # ##
##                                                        ##
##  # # # # # # # # # # # # # # # # # # # # # # # # # # # ##
##                                                        ##
##  # # # # # # # # # # # # # # # # # # # # # # # # # # # ##
##                                                        ##
##  # # # # # # # # # # # # # # # # # # # # # # # # # # # ##
##                                                        ##
##  # # # # # # # # # # # # # # # # # # # # # # # # # # # ##
##                                                        ##
##  # # # # # # # # # # # # # # # # # # # # # # # # # # # ##
##                                                        ##
##  # # # # # # # # # # # # # # # # # # # # # # # # # # # ##
##                                I                       ##
##  # # # # # # # # # # # # # # # # # # # # # # # # # # # ##
##                                                        ##
##  # # # # # # # # # # # # # # # # # # # # # # # # # # # ##
##                                                        ##
##  # # # # # # # # # # # # # # # # # # # # # # # # # # # ##
##                                                        ##
##  # # # # # # # # # # # # # # # # # # # # # # # # # # # ##
##                                                        ##
##  # # # # # # # # # # # # # # # # # # # # # # # # # # # ##
##                                              B         ##
##    J                                                   ##
############################################################
############################################################
